1121124122
1122122111
3112222221
1121111211
2122121211
2121121121
1111221111
2122222111
1122112121
2111111111
