3111121422
1212122112
2112221121
1121121212
2121121211
2121121112
1121222122
2121122111
1122112121
2111111111
