22222222222222222222222222222222222222222222222222
21111111111111111111111111111111111111111111111112
21111111111222111111111222211122222222222211121112
21121111111222111211111111111111111111111112121112
21121111112211111211122222121221122222111111112112
21121111112111111211111111111111111111122222222212
21121111122111111211211122111111211111211111122112
21121111122111112211211122112111111111111111112112
21121111121111112112211122112121112111111111112112
21112111122311112112111111112111111111111112211112
21112111122111122112112122222222222221222222112112
21111111122111121111112111111111212111111221111112
21111121122111111121112111211111112111111211112112
21111121122112111121112111111111211111121111112112
21111122222112111111112111111222111111221111112112
21111111122112111211112111111112111122211121111112
21111111122111111211112111111112221122111111211122
21111111122222211111112111111111122222111122111112
22222222121111112111112111111111122111111221111112
22222222121112222221222111111121122111112211111112
22211111121111111111112111111211221111222111111212
21111111221111111111112111111122221112211111112212
21111111211111111111112111211222112211111111222112
21111111211111111111111121112221122111121122211112
21111111211111111111111111122111221111111221111112
21111112211112222211111122221112211114222211111122
21111122111111111111212112221112121111221111111112
21111121111111111211111122111112111111221111111112
21111221111112121111111221111122112222211111111112
21111211112211111111122211111111112111111111111112
21111211111111112122221111111112211111111111111112
21112211111111122122211111111122111111111111112112
21112111111111111122111111122111111111111111111112
21112111111111111111111111121111111111111111111212
21122111111111111111111111221111111111111111111122
21122221222111111111111112211111111111111111111112
21121111112222222222222222222222122122212222221112
21121111111111211111111112221111111111111111111112
21121111111111211211111111112221111111111111111112
21121111111111211211111111111111111111111111111112
21121111111111211211111111111222222111111111111112
21122111111111111211111111111111111111111111111112
21112211111111111212222122222222221111111111111112
21112221111111111111111111111111111111111111111112
21111122122222211221221122222212222221222221111112
21111111111111111111111111111111111111111111111112
21111111111111111111111111111111111111111111111112
21111111111111111111111111111111111111111111111112
21111111111111111111111111111111111111111111111112
22222222222222222222222222222222222222222222222222
