1121121122
1322122111
1112222221
1121111214
2122121211
2121121121
1111221111
2122222111
1122112121
2111111111
